###############################
#      ** *  1 * 2 *  * * *   #
# # # #*# # #*# # # # #*#*#*# #
#   *  2  ***  *  1   * 2 * * #
# # # # # #*# # # #*# # # # #*#
#    1     x ** 3   *   1  5  #
# # # # # # # # # #*# #*# # # #
#*  *      *  *      *        #
# # # # #*# # # #*#*# # # # # #
#*    **  *       *      2    #
# #*# # # # # # #*# # # # # # #
#   4  2    *   *  *     2    #
###############################