###############################
#      ** *  1 * 2 *  * * *   #
# # # #*# # #*# # # # #*#*#*# #
#  x*  2  ***  *  1   * 2 * * #
# # # # # #*# # # #*# # # # #*#
#f         x **     *   1     #
# # # # # # # # # #*# #*# # # #
#*  *      *  *      *        #
# # # # #*# # # #*#*# # # # # #
#*    **  *       *           #
# #*# # # # # # #*# # # # # # #
#           *   *  *          #
###############################