###############################
#      ** *    * 7 *  * * *   #
# # # #*# # #*# # # # #*#*#*# #
#   *     ***  *      * 2 * * #
# # # # # #*# # # #*# # # # #*#
#       1  x ** 3   *      5  #
# # # # # # # # # #*# #*# # # #
#*  *      *  *      *        #
# # # # #*# # # #*#*# # # # # #
#*    **  *    8  *     6     #
# #*# # # # # # #*# # # # # # #
#    4      *   *  *     2    #
###############################