###############################
#      ** *    * 7 *  * * *   #
# # # #*# # #*# # # # #*#*#*# #
#   *     ***  *      * 2 * * #
# # # # # #*# # # #*# # # # #*#
#       1  x ** 3   *      5  #
# # # # # # # # # #*# #*# # # #
#*  *      *  *    6 *        #
# # # # #*# # # #*#*# # # # # #
#*    **  *    8  *           #
# #*# # # # # # #*# # # # # # #
#    4      *   *  *     2    #
###############################