###############################
#      ** *  1 * 2 *  * * *   #
# # # #*# # #*# # # # #*#*#*# #
#   *  2  ***  *  1   * 2 * * #
# # # # # #*# # # #*# # # # #*#
#f   1     x **     *   1     #
# # # # # # # # # #*# #*# # # #
#*  *      *  *      *        #
# # # # #*# # # #*#*# # # # # #
#*    **  *       *      2    #
# #*# # # # # # #*# # # # # # #
#      2    *   *  *     2    #
###############################